####################
#..................#
#..................#
#..##........##...#
#..##........##...#
#..................#
#..................#
#..................#
#..................#
#...####....####...#
#...#..........#...#
#...#..........#...#
#...####....####...#
#..................#
#..................#
####################
